31462346236
4,2,1
0,0,0,0,0,0,0,11
0,0,0,0,0,0,12,12
0,0,0,12,0,0,0,0
0,0,0,0,0,0,0,0
0,0,0,0,0,0,0,0
99,99,99,0,99,99,99,99
0,1,3,0,0,0,0,0
0,2,3,0,0,0,0,0