In for a penny, in for a pound I suppose. Given that didn't go so well for the villagers, we may as well head on in and see how the rest of the villagers are getting on.
6607342315635
1,2,2
02,00,13,13,00,00,00,00
00,99,99,12,00,99,99,00
00,99,99,12,00,99,99,00
00,12,00,11,00,11,00,00
00,00,00,00,11,00,00,00
00,12,00,99,99,00,00,00
00,00,00,99,99,00,00,00
12,12,00,00,00,00,00,00