10,5,5
0,0,0,0,0,0,0,11
0,0,0,0,0,0,12,12
0,0,0,0,0,0,0,0
0,0,0,0,0,0,0,0
0,0,0,0,0,0,0,0
0,0,0,0,0,0,0,0
0,1,3,0,0,0,0,0
0,2,3,0,0,0,0,0