2113462325346
4,2,1
0,0,0,0,0,0,0,11
0,0,0,0,0,0,12,12
0,0,0,12,0,0,0,0
0,0,0,0,0,0,0,0
0,0,0,0,0,0,0,0
0,0,0,0,0,0,0,0
0,1,3,3,0,0,0,0
0,2,3,0,0,0,0,0